0000000000000000000000000000000
0111110111111111111111110111110
0100010100010000000100010111110
0101110101111110111111010111110
0111000101000010100001110001110
0001010101011111101101011101000
0111010001010001000101000101110
0100011111110111110111111100010
0111010000010000000101000101110
0001011101011110111101011101000
0111000101000010100001010001110
0111111101111110111111011111010
0111110100010000000100010100010
0111110111111111111101110111110
0000000000000000000000000000000
